[
  [
    4, 4, 4, 4, 4, 4, 4, 4, 4, 4, 4, 4, 4, 4, 4, 4, 4, 4, 4, 4, 4, 4, 4, 4, 4,
    4, 4, 4, 4, 4, 4, 4, 4, 4, 4, 4, 4, 4, 4, 4, 4, 4, 4
  ],
  [
    4, -1, -1, -1, -1, -1, -1, -1, -1, -1, -1, -1, -1, -1, -1, -1, -1, -1, -1,
    -1, -1, -1, -1, -1, -1, -1, -1, -1, -1, -1, -1, -1, -1, -1, -1, -1, -1, -1,
    -1, -1, -1, -1, 4
  ],
  [
    4, -1, -1, -1, -1, -1, -1, -1, -1, -1, -1, -1, -1, -1, -1, -1, -1, -1, -1,
    -1, -1, -1, -1, -1, -1, -1, -1, -1, -1, -1, -1, -1, -1, -1, -1, -1, -1, -1,
    -1, -1, -1, -1, 4
  ],
  [
    4, -1, -1, -1, -1, -1, -1, -1, -1, -1, -1, -1, -1, -1, -1, -1, -1, -1, -1,
    -1, -1, -1, -1, -1, -1, -1, -1, -1, -1, -1, -1, -1, -1, -1, -1, -1, -1, -1,
    -1, -1, -1, -1, 4
  ],
  [
    4, -1, -1, -1, -1, -1, -1, -1, -1, -1, -1, -1, -1, -1, -1, -1, -1, -1, -1,
    -1, -1, -1, -1, -1, -1, -1, -1, -1, -1, -1, -1, -1, -1, -1, -1, -1, -1, -1,
    -1, -1, -1, -1, 4
  ],
  [
    4, -1, -1, -1, -1, -1, -1, -1, -1, -1, -1, -1, -1, -1, -1, 11, 15, -1, 9,
    -1, -1, -1, -1, -1, 9, -1, -1, -1, -1, -1, -1, -1, -1, -1, -1, -1, -1, -1,
    -1, -1, -1, -1, 4
  ],
  [
    4, -1, -1, -1, -1, -1, 10, -1, -1, -1, -1, -1, -1, -1, -1, -1, -1, -1, -1,
    -1, -1, -1, -1, -1, -1, -1, -1, -1, -1, -1, -1, -1, -1, -1, -1, -1, -1, -1,
    -1, -1, 10, -1, 4
  ],
  [
    4, 9, -1, -1, -1, -1, -1, -1, -1, -1, -1, -1, -1, -1, -1, 2, 3, -1, -1, 2,
    -1, -1, -1, 2, 3, -1, -1, 2, -1, -1, -1, -1, 11, -1, -1, 19, -1, -1, -1, -1,
    -1, -1, 4
  ],
  [
    4, -1, -1, 17, 13, -1, -1, -1, -1, -1, -1, -1, -1, -1, -1, -1, -1, -1, -1,
    -1, -1, -1, -1, -1, -1, -1, -1, -1, -1, -1, -1, -1, -1, -1, -1, -1, -1, -1,
    13, 17, -1, -1, 4
  ],
  [
    4, 8, -1, -1, 5, 8, -1, -1, 8, -1, -1, -1, -1, -1, -1, -1, -1, -1, -1, -1,
    -1, 18, -1, -1, -1, -1, -1, -1, -1, -1, -1, -1, 8, -1, -1, 8, -1, -1, 5, 8,
    -1, -1, 4
  ],
  [
    4, -1, -1, -1, -1, -1, -1, -1, -1, -1, -1, -1, -1, -1, -1, -1, -1, -1, -1,
    3, -1, -1, 3, -1, -1, -1, -1, -1, -1, -1, -1, -1, -1, -1, -1, -1, -1, -1,
    -1, -1, -1, -1, 4
  ],
  [
    4, -1, -1, -1, -1, -1, -1, -1, -1, -1, -1, -1, -1, -1, -1, -1, -1, -1, -1,
    -1, 10, -1, -1, -1, -1, -1, -1, -1, -1, -1, -1, -1, -1, -1, -1, -1, -1, -1,
    -1, -1, -1, -1, 4
  ],
  [
    4, -1, -1, -1, -1, -1, -1, -1, -1, -1, -1, -1, -1, -1, -1, -1, -1, -1, -1,
    -1, -1, 12, -1, -1, -1, -1, -1, 16, -1, -1, -1, -1, -1, -1, -1, -1, -1, -1,
    -1, -1, -1, -1, 4
  ],
  [
    4, -1, 9, -1, -1, -1, -1, -1, -1, -1, -1, -1, -1, -1, 8, -1, -1, 14, 8, -1,
    -1, 5, 8, -1, -1, 14, 8, -1, -1, -1, -1, 11, -1, -1, -1, -1, -1, -1, -1, -1,
    9, 12, 4
  ],
  [
    4, 12, -1, -1, -1, -1, -1, -1, -1, 18, -1, -1, -1, -1, -1, -1, -1, 5, -1,
    -1, -1, -1, -1, -1, -1, 5, -1, -1, -1, -1, -1, -1, 18, -1, -1, -1, -1, -1,
    -1, -1, -1, -1, 4
  ],
  [
    4, 3, -1, -1, -1, -1, -1, 3, -1, -1, 3, -1, -1, -1, -1, -1, -1, -1, -1, -1,
    -1, -1, -1, -1, -1, -1, -1, -1, -1, -1, 3, -1, -1, 3, -1, -1, -1, -1, -1, 3,
    -1, -1, 4
  ],
  [
    4, -1, -1, -1, -1, -1, -1, -1, -1, -1, -1, -1, -1, -1, -1, -1, -1, -1, -1,
    -1, -1, -1, -1, -1, -1, -1, -1, -1, -1, -1, -1, -1, -1, -1, -1, -1, -1, -1,
    -1, -1, -1, -1, 4
  ],
  [
    4, -1, 19, -1, -1, -1, -1, -1, -1, -1, -1, -1, -1, -1, -1, -1, -1, -1, -1,
    -1, -1, -1, -1, -1, -1, -1, -1, -1, -1, -1, -1, -1, -1, -1, -1, -1, -1, -1,
    11, 19, -1, -1, 4
  ],
  [
    4, -1, -1, -1, -1, -1, -1, -1, 3, -1, -1, -1, -1, -1, -1, -1, -1, -1, -1,
    -1, -1, -1, -1, -1, -1, -1, -1, -1, -1, -1, -1, -1, 3, -1, -1, -1, -1, -1,
    -1, -1, -1, -1, 4
  ],
  [
    4, 7, -1, -1, 6, -1, -1, -1, -1, -1, -1, -1, -1, -1, -1, -1, -1, -1, -1, -1,
    -1, -1, -1, -1, -1, -1, -1, -1, -1, -1, -1, -1, -1, -1, -1, -1, -1, 6, -1,
    7, -1, -1, 4
  ],
  [
    4, -1, -1, -1, -1, -1, -1, -1, -1, -1, -1, -1, -1, -1, -1, -1, -1, -1, -1,
    19, -1, -1, 15, -1, -1, 10, -1, -1, -1, -1, -1, -1, -1, -1, -1, -1, -1, -1,
    -1, -1, -1, -1, 4
  ],
  [
    4, -1, -1, -1, 1, -1, -1, -1, -1, 5, -1, -1, 11, -1, 12, 11, -1, -1, -1, 5,
    14, 14, 5, -1, -1, -1, -1, -1, 12, -1, -1, 5, 5, 5, -1, -1, -1, 11, -1, -1,
    12, -1, 4
  ],
  [
    4, -1, -1, -1, -1, -1, -1, 18, 13, -1, 13, -1, -1, -1, -1, -1, -1, -1, 13,
    -1, 6, -1, -1, 13, -1, -1, -1, -1, -1, -1, 13, -1, -1, -1, 13, -1, -1, -1,
    -1, -1, -1, -1, 4
  ],
  [
    7, -1, -1, 7, -1, -1, 7, -1, -1, -1, 7, -1, -1, 7, -1, -1, 7, -1, -1, -1, 4,
    4, 7, -1, -1, 7, -1, -1, 7, -1, -1, -1, -1, -1, 7, -1, -1, 7, -1, -1, 7, -1,
    -1
  ]
]
